signal_name, length, matches, checks, pc_accuracy, psas, psan, pnas, pnan
672-122797-0000,65120,47,63,74.60317460317461,30,0,16,17
1995-1837-0023,271440,200,264,75.75757575757575,166,3,61,34
260-123288-0024,233520,152,227,66.96035242290749,119,3,72,33
5683-32879-0013,183920,100,179,55.865921787709496,66,2,77,34
6829-68771-0018,135120,90,131,68.70229007633588,67,2,39,23
6930-75918-0018,172960,50,168,29.761904761904763,28,4,114,22
1284-1180-0028,96720,68,94,72.3404255319149,56,0,26,12
237-134493-0010,46000,36,44,81.81818181818183,26,0,8,10
7176-92135-0033,35680,28,34,82.35294117647058,24,1,5,4
2961-960-0002,245600,114,239,47.69874476987448,77,6,119,37
8455-210777-0022,261760,193,255,75.68627450980392,136,2,60,57
4077-13751-0000,152960,96,149,64.42953020134227,77,1,52,19
5639-40744-0002,142560,90,139,64.74820143884892,60,1,48,30
4970-29093-0019,119520,51,116,43.96551724137931,23,0,65,28
1284-1181-0005,61680,50,60,83.33333333333334,41,1,9,9
5683-32866-0007,65920,49,64,76.5625,35,0,15,14
5683-32866-0017,73360,48,71,67.6056338028169,35,2,21,13
3575-170457-0009,107680,84,105,80.0,64,0,21,20
5142-33396-0015,68960,31,67,46.26865671641791,21,0,36,10
1320-122617-0037,114880,82,112,73.21428571428571,70,1,29,12
2094-142345-0055,42480,31,41,75.60975609756098,21,0,10,10
3575-170457-0029,96880,66,94,70.2127659574468,50,2,26,16
2094-142345-0054,90880,65,88,73.86363636363636,40,6,17,25
672-122797-0051,74640,43,72,59.72222222222222,28,1,28,15
2300-131720-0026,281520,216,274,78.83211678832117,173,2,56,43
4507-16021-0034,180320,94,175,53.714285714285715,60,3,78,34
7127-75946-0025,63360,38,61,62.295081967213115,20,4,19,18
8555-284447-0007,101840,69,99,69.6969696969697,52,2,28,17
4077-13754-0016,190320,104,185,56.21621621621622,65,4,77,39
5105-28240-0004,96240,61,93,65.59139784946237,43,1,31,18
4507-16021-0049,94560,61,92,66.30434782608695,45,0,31,16
6829-68769-0024,79120,59,77,76.62337662337663,47,0,18,12
7176-92135-0005,87520,76,85,89.41176470588236,63,1,8,13
8463-294825-0004,58880,37,57,64.91228070175438,28,0,20,9
260-123440-0007,54160,41,52,78.84615384615384,32,1,10,9
4446-2273-0035,98400,41,96,42.70833333333333,19,2,53,22
908-31957-0025,328960,225,320,70.3125,101,13,82,124
1284-1180-0019,240400,173,234,73.93162393162393,149,2,59,24
2830-3980-0024,62960,39,61,63.934426229508205,28,3,19,11
7176-92135-0024,65600,53,64,82.8125,43,1,10,10
61-70968-0022,74720,46,72,63.888888888888886,38,1,25,8
4992-23283-0008,78560,44,76,57.89473684210527,28,1,31,16
672-122797-0016,147440,90,143,62.93706293706294,52,3,50,38
237-134493-0015,104800,76,102,74.50980392156863,65,3,23,11
1089-134686-0003,42880,33,41,80.48780487804879,23,1,7,10
908-31957-0023,136240,96,132,72.72727272727273,53,4,32,43
121-123852-0004,260640,133,254,52.362204724409445,65,5,116,68
237-126133-0020,35840,14,34,41.17647058823529,7,1,19,7
1320-122617-0031,100560,81,98,82.6530612244898,66,1,16,15
4446-2275-0021,80800,44,78,56.41025641025641,15,1,33,29
1284-1180-0004,68560,50,66,75.75757575757575,42,0,16,8
7021-79730-0006,181440,130,177,73.44632768361582,95,5,42,35
1089-134691-0015,54320,36,52,69.23076923076923,13,5,11,23
672-122797-0065,48480,26,47,55.319148936170215,12,1,20,14
2961-960-0005,165680,94,161,58.38509316770186,56,2,65,38
7176-88083-0007,228800,177,223,79.37219730941703,146,0,46,31
7176-92135-0004,38800,31,37,83.78378378378379,25,2,4,6
5683-32866-0023,43920,27,42,64.28571428571429,17,1,14,10
7021-79740-0009,58160,47,56,83.92857142857143,39,0,9,8
7729-102255-0030,116000,82,113,72.56637168141593,59,1,30,23
908-157963-0006,129760,94,126,74.60317460317461,66,1,31,28
260-123288-0020,46400,31,45,68.88888888888889,21,1,13,10
2830-3980-0060,42800,23,41,56.09756097560976,17,2,16,6
1221-135767-0005,93840,50,91,54.94505494505495,28,3,38,22
1221-135767-0006,328960,150,320,46.875,97,2,168,53
2830-3979-0001,258000,185,251,73.70517928286853,135,1,65,50
7176-92135-0036,103520,88,100,88.0,78,1,11,10
7021-85628-0026,43840,33,42,78.57142857142857,23,0,9,10
5142-33396-0029,34160,16,33,48.484848484848484,10,0,17,6
8230-279154-0039,73440,56,71,78.87323943661971,42,0,15,14
4446-2271-0008,87920,67,85,78.82352941176471,58,0,18,9
1089-134686-0034,92960,52,90,57.77777777777777,29,2,36,23
6930-75918-0017,98560,31,96,32.29166666666667,16,1,64,15
7729-102255-0043,176560,132,172,76.74418604651163,106,4,36,26
5683-32866-0022,51040,25,49,51.02040816326531,12,1,23,13
7127-75947-0021,63920,35,62,56.451612903225815,17,0,27,18
1089-134686-0011,199120,116,194,59.79381443298969,90,6,72,26
1089-134691-0012,240480,146,234,62.39316239316239,100,3,85,46
7021-79759-0005,208320,153,203,75.36945812807882,115,3,47,38
1580-141084-0006,34160,15,33,45.45454545454545,9,1,17,6
1580-141084-0021,64160,19,62,30.64516129032258,6,1,42,13
6930-76324-0008,82960,26,80,32.5,18,1,53,8
2830-3980-0073,264960,178,258,68.9922480620155,130,7,73,48
6829-68769-0009,67520,50,65,76.92307692307693,39,1,14,11
8463-294828-0019,72480,39,70,55.714285714285715,32,3,28,7
1221-135766-0002,77200,37,75,49.333333333333336,14,1,37,23
7127-75947-0014,161840,101,157,64.3312101910828,72,3,53,29
237-134500-0033,101600,65,99,65.65656565656566,35,4,30,30
5683-32879-0016,162960,87,158,55.06329113924051,53,1,70,34
8455-210777-0042,76480,53,74,71.62162162162163,37,0,21,16
2961-960-0015,125280,69,122,56.557377049180324,43,1,52,26
5683-32866-0030,77520,38,75,50.66666666666667,19,1,36,19
6930-75918-0019,186320,64,181,35.35911602209944,44,1,116,20
7021-79740-0000,178000,129,173,74.56647398843931,101,2,42,28
8455-210777-0054,40320,31,39,79.48717948717949,17,1,7,14
2094-142345-0000,361120,287,352,81.5340909090909,212,5,60,75
5105-28233-0007,418240,217,408,53.18627450980392,131,3,188,86
2300-131720-0010,173120,143,168,85.11904761904762,115,2,23,28
8555-284447-0006,207280,140,202,69.3069306930693,108,3,59,32
1320-122617-0038,35840,28,34,82.35294117647058,21,0,6,7
121-127105-0021,32000,18,31,58.06451612903226,12,0,13,6
8463-294825-0013,282240,148,275,53.81818181818182,109,3,124,39
6930-75918-0003,373040,117,363,32.231404958677686,67,7,239,50
3570-5695-0013,74240,57,72,79.16666666666666,49,1,14,8
5142-36586-0001,35440,24,34,70.58823529411765,18,0,10,6
2094-142345-0021,85360,69,83,83.13253012048193,50,2,12,19
7176-92135-0044,82800,64,80,80.0,56,0,16,8
5639-40744-0028,196000,74,191,38.7434554973822,26,6,111,48
8230-279154-0000,140880,94,137,68.61313868613139,76,1,42,18
4992-41806-0003,147840,86,144,59.72222222222222,64,2,56,22
8463-294828-0025,31840,17,31,54.83870967741935,12,2,12,5
6829-68771-0014,76320,45,74,60.810810810810814,30,0,29,15
7021-85628-0004,44880,27,43,62.7906976744186,13,0,16,14
2300-131720-0039,38160,26,37,70.27027027027027,13,1,10,13
237-134500-0017,34880,27,34,79.41176470588235,22,0,7,5
5142-36377-0006,74160,42,72,58.333333333333336,36,2,28,6
8230-279154-0037,328560,225,320,70.3125,172,2,93,53
4992-23283-0017,229040,105,223,47.08520179372198,73,3,115,32
4507-16021-0025,147440,90,143,62.93706293706294,47,2,51,43
2300-131720-0004,318560,266,310,85.80645161290322,221,2,42,45
237-134500-0016,50560,36,49,73.46938775510205,22,1,12,14
2830-3980-0069,88880,61,86,70.93023255813954,48,2,23,13
5142-33396-0050,46160,20,45,44.44444444444444,15,2,23,5
4507-16021-0004,34160,24,33,72.72727272727273,13,0,9,11
8463-294828-0003,149440,87,145,60.0,63,2,56,24
4970-29093-0021,38800,21,37,56.75675675675676,10,1,15,11
7127-75947-0010,141840,79,138,57.2463768115942,58,2,57,21
4077-13751-0020,164720,104,160,65.0,80,1,55,24
1995-1837-0008,31280,25,30,83.33333333333334,21,1,4,4
8463-294828-0017,148800,89,145,61.37931034482759,64,0,56,25
4507-16021-0014,97840,64,95,67.36842105263158,26,3,28,38
8455-210777-0047,40640,32,39,82.05128205128204,19,0,7,13
2094-142345-0032,51840,46,50,92.0,37,0,4,9
7021-85628-0015,184720,128,180,71.11111111111111,92,3,49,36
6829-68769-0003,67440,43,65,66.15384615384615,36,0,22,7
260-123440-0000,34640,24,33,72.72727272727273,17,1,8,7
8555-284447-0017,185920,107,181,59.11602209944752,82,1,73,25
7176-92135-0028,53520,45,52,86.53846153846155,39,0,7,6
4970-29095-0031,240800,153,234,65.38461538461539,108,5,76,45
7021-85628-0009,136640,103,133,77.44360902255639,82,0,30,21
8463-294828-0012,78480,49,76,64.47368421052632,34,3,24,15
237-134500-0003,50720,35,49,71.42857142857143,27,1,13,8
8463-294828-0029,84560,48,82,58.536585365853654,30,3,31,18
2830-3980-0062,87040,64,84,76.19047619047619,41,1,19,23
260-123286-0022,51760,31,50,62.0,21,1,18,10
7021-79740-0013,117840,89,114,78.0701754385965,68,0,25,21
5105-28233-0002,132560,79,129,61.240310077519375,56,0,50,23
8224-274384-0002,157040,113,153,73.8562091503268,87,1,39,26
4970-29093-0011,183200,90,178,50.56179775280899,45,2,86,45
1995-1837-0014,199360,151,194,77.83505154639175,123,1,42,28
8230-279154-0032,62080,41,60,68.33333333333333,29,0,19,12
61-70970-0000,97200,63,94,67.02127659574468,55,2,29,8
260-123288-0014,28880,21,28,75.0,12,0,7,9
1188-133604-0034,334480,238,326,73.00613496932516,161,10,78,77
4446-2275-0038,72480,42,70,60.0,29,1,27,13
8463-287645-0011,102080,60,99,60.60606060606061,43,1,38,17
5105-28233-0003,236960,121,231,52.38095238095239,88,3,107,33
672-122797-0047,53200,39,51,76.47058823529412,29,1,11,10
8555-292519-0002,28960,22,28,78.57142857142857,6,0,6,16
1089-134686-0032,65440,46,63,73.01587301587301,29,1,16,17
8230-279154-0022,103040,74,100,74.0,57,1,25,17
2300-131720-0022,218640,175,213,82.15962441314554,143,2,36,32
6829-68771-0023,86800,60,84,71.42857142857143,39,1,23,21
5142-36586-0000,58400,32,56,57.14285714285714,21,1,23,11
1284-1180-0001,124080,88,121,72.72727272727273,71,0,33,17
4446-2273-0036,49920,14,48,29.166666666666668,3,2,32,11
4507-16021-0007,42080,24,41,58.536585365853654,16,3,14,8
4970-29095-0038,139840,69,136,50.73529411764706,44,3,64,25
7176-88083-0005,75200,61,73,83.56164383561644,50,0,12,11
1580-141083-0043,43840,28,42,66.66666666666666,16,0,14,12
3575-170457-0018,46720,34,45,75.55555555555556,10,0,11,24
1580-141083-0024,71680,38,69,55.072463768115945,17,0,31,21
1580-141083-0007,73040,29,71,40.845070422535215,19,3,39,10
1089-134686-0036,52000,27,50,54.0,17,0,23,10
3729-6852-0022,133040,69,129,53.48837209302325,42,3,57,27
2300-131720-0034,137680,107,134,79.8507462686567,90,1,26,17
4077-13751-0004,266880,181,260,69.61538461538461,142,6,73,39
8455-210777-0016,259840,201,253,79.44664031620553,149,4,48,52
2830-3979-0010,53760,37,52,71.15384615384616,21,0,15,16
6829-68769-0002,49200,36,48,75.0,27,0,12,9
4992-23283-0002,49920,25,48,52.083333333333336,13,2,21,12
1284-1180-0011,68400,62,66,93.93939393939394,49,0,4,13
5105-28240-0023,281120,183,274,66.78832116788321,134,5,86,49
7176-88083-0020,86640,57,84,67.85714285714286,48,0,27,9
7729-102255-0021,126880,92,123,74.79674796747967,70,1,30,22
5639-40744-0012,137520,69,134,51.49253731343284,47,1,64,22
6930-75918-0008,76560,29,74,39.189189189189186,8,1,44,21
8463-294825-0009,320080,176,312,56.41025641025641,131,2,134,45
7127-75946-0026,322400,155,314,49.36305732484077,104,4,155,51
8463-294828-0018,47120,34,45,75.55555555555556,15,1,10,19
1320-122617-0029,126000,100,122,81.9672131147541,84,1,21,16
1580-141083-0005,43920,16,42,38.095238095238095,7,3,23,9
237-126133-0019,113920,43,111,38.73873873873874,22,2,66,21
4970-29095-0013,31680,22,30,73.33333333333333,5,0,8,17
7176-88083-0017,58560,46,57,80.7017543859649,42,1,10,4
5105-28240-0017,90640,54,88,61.36363636363637,37,1,33,17
4446-2275-0041,76080,39,74,52.702702702702695,23,0,35,16
121-123852-0002,276560,147,269,54.646840148698885,73,7,115,74
237-134500-0031,169760,119,165,72.12121212121212,93,1,45,26
1188-133604-0018,184800,126,180,70.0,98,2,52,28
3575-170457-0021,66880,45,65,69.23076923076923,33,1,19,12
5639-40744-0040,200160,104,195,53.333333333333336,71,2,89,33
8555-284449-0019,121760,71,118,60.16949152542372,51,1,46,20
672-122797-0004,164000,124,160,77.5,78,1,35,46
6829-68771-0002,143040,101,139,72.66187050359713,83,0,38,18
4077-13754-0007,223200,129,217,59.44700460829493,96,4,84,33
2094-142345-0026,45200,33,44,75.0,23,1,10,10
8463-294825-0006,178160,93,173,53.75722543352601,74,4,76,19
121-127105-0009,36640,19,35,54.285714285714285,15,0,16,4
5639-40744-0025,140560,71,137,51.82481751824818,38,2,64,33
6930-76324-0005,80560,28,78,35.8974358974359,14,0,50,14
5683-32879-0023,79600,40,77,51.94805194805194,26,1,36,14
1089-134686-0006,168880,113,164,68.90243902439023,82,2,49,31
7127-75946-0013,137280,74,133,55.639097744360896,45,5,54,29
4446-2273-0030,46160,28,45,62.22222222222222,16,1,16,12
4507-16021-0015,61760,45,60,75.0,28,0,15,17
3570-5694-0013,89760,57,87,65.51724137931035,48,2,28,9
2094-142345-0018,50480,32,49,65.3061224489796,24,2,15,8
4970-29093-0023,129120,56,125,44.800000000000004,29,1,68,27
5142-36377-0021,301920,112,294,38.095238095238095,88,4,178,24
6829-68771-0006,94720,64,92,69.56521739130434,51,0,28,13
7127-75947-0032,75920,47,74,63.51351351351351,13,5,22,34
672-122797-0054,68000,39,66,59.09090909090909,18,2,25,21
7021-79740-0012,52160,30,50,60.0,18,3,17,12
1995-1837-0001,139680,104,136,76.47058823529412,86,2,30,18
1284-1181-0021,43200,25,42,59.523809523809526,17,0,17,8
1580-141084-0050,44480,14,43,32.55813953488372,5,0,29,9
61-70968-0031,46800,26,45,57.77777777777777,21,2,17,5
3729-6852-0011,117920,48,115,41.73913043478261,29,2,65,19
260-123286-0014,47680,34,46,73.91304347826086,21,1,11,13
1089-134686-0004,83440,66,81,81.48148148148148,41,0,15,25
5142-33396-0011,56320,15,54,27.77777777777778,8,0,39,7
4970-29095-0009,89600,53,87,60.91954022988506,30,1,33,23
1188-133604-0020,164160,126,160,78.75,81,2,32,45
2830-3980-0076,76960,57,75,76.0,43,2,16,14
2961-960-0013,169200,95,165,57.57575757575758,60,2,68,35
7127-75946-0023,59920,34,58,58.620689655172406,19,2,22,15
5683-32879-0014,134480,68,131,51.908396946564885,48,5,58,20
237-134493-0002,182320,131,177,74.01129943502825,91,0,46,40
5105-28241-0015,466240,247,454,54.40528634361234,157,9,198,90
5142-36377-0020,72480,25,70,35.714285714285715,21,1,44,4
61-70968-0018,38480,26,37,70.27027027027027,15,0,11,11
8230-279154-0034,232160,155,226,68.58407079646017,114,3,68,41
7021-79730-0002,43040,36,41,87.8048780487805,18,1,4,18
5142-33396-0046,59920,31,58,53.44827586206896,26,1,26,5
908-31957-0024,120640,91,117,77.77777777777779,48,2,24,43
121-121726-0005,49600,36,48,75.0,9,4,8,27
61-70968-0003,69040,48,67,71.64179104477611,34,2,17,14
1995-1837-0026,129520,98,126,77.77777777777779,81,4,24,17
8224-274381-0007,161360,113,157,71.97452229299363,82,2,42,31
4507-16021-0056,101520,62,99,62.62626262626263,33,5,32,29
4970-29093-0007,111920,62,109,56.88073394495413,29,3,44,33
4992-41806-0008,189120,125,184,67.93478260869566,87,1,58,38
908-157963-0029,58080,46,56,82.14285714285714,31,0,10,15
237-134500-0026,48800,40,47,85.1063829787234,28,2,5,12
2830-3980-0070,59680,46,58,79.3103448275862,23,3,9,23
2094-142345-0013,228000,171,222,77.02702702702703,128,3,48,43
6930-81414-0009,192240,73,187,39.037433155080215,39,4,110,34
6829-68769-0023,78240,63,76,82.89473684210526,49,0,13,14
672-122797-0015,71280,40,69,57.971014492753625,31,0,29,9
3729-6852-0015,41760,20,40,50.0,4,2,18,16
260-123286-0008,59760,34,58,58.620689655172406,23,0,24,11
1284-1181-0002,61360,46,59,77.96610169491525,36,1,12,10
237-134493-0012,58560,48,57,84.21052631578947,37,0,9,11
61-70968-0032,68480,53,66,80.3030303030303,38,0,13,15
5683-32865-0016,48960,37,47,78.72340425531915,26,0,10,11
8224-274381-0013,217760,164,212,77.35849056603774,125,4,44,39
1995-1836-0000,143280,101,139,72.66187050359713,90,4,34,11
5142-33396-0047,40560,21,39,53.84615384615385,16,1,17,5
7729-102255-0045,108880,74,106,69.81132075471697,51,0,32,23
3575-170457-0010,76640,59,74,79.72972972972973,48,1,14,11
7729-102255-0017,241760,151,235,64.25531914893618,113,0,84,38
1284-1181-0000,63440,47,61,77.04918032786885,38,2,12,9
3570-5695-0006,119520,81,116,69.82758620689656,69,0,35,12
2830-3980-0053,80240,60,78,76.92307692307693,41,4,14,19
4446-2275-0006,56640,31,55,56.36363636363636,25,0,24,6
8463-287645-0009,59360,38,57,66.66666666666666,33,1,18,5
5142-33396-0016,34640,11,33,33.33333333333333,5,0,22,6
7176-92135-0014,256320,203,250,81.2,173,1,46,30
8224-274381-0011,103680,73,101,72.27722772277228,50,0,28,23
7127-75947-0026,104880,64,102,62.745098039215684,41,2,36,23
260-123286-0007,72800,51,71,71.83098591549296,39,1,19,12
8224-274381-0000,283840,201,276,72.82608695652173,149,7,68,52
2830-3980-0022,52320,29,51,56.86274509803921,16,1,21,13
6829-68771-0000,213040,148,207,71.49758454106279,122,2,57,26
1320-122612-0011,219120,156,213,73.23943661971832,129,2,55,27
672-122797-0011,40640,20,39,51.28205128205128,16,0,19,4
7021-85628-0007,266800,196,260,75.38461538461539,142,1,63,54
260-123286-0025,147280,105,143,73.42657342657343,77,1,37,28
8455-210777-0010,49600,32,48,66.66666666666666,18,0,16,14
4992-41797-0006,72800,56,71,78.87323943661971,45,0,15,11
8555-292519-0005,153200,105,149,70.46979865771812,78,2,42,27
1221-135766-0004,119040,52,116,44.827586206896555,30,1,63,22
5639-40744-0021,175680,71,171,41.52046783625731,43,3,97,28
8463-287645-0014,48320,33,47,70.2127659574468,24,1,13,9
3570-5695-0008,109520,64,106,60.37735849056604,52,1,41,12
5639-40744-0016,151840,74,148,50.0,48,0,74,26
8463-294828-0028,126640,69,123,56.09756097560976,50,1,53,19
7729-102255-0023,88000,63,85,74.11764705882354,54,0,22,9
5683-32865-0006,53600,33,52,63.46153846153846,17,0,19,16
6829-68771-0035,70240,49,68,72.05882352941177,42,0,19,7
6829-68769-0028,52640,34,51,66.66666666666666,26,1,16,8
237-134493-0003,204240,141,199,70.85427135678391,122,4,54,19
1284-1181-0019,51200,45,49,91.83673469387756,40,0,4,5
8463-287645-0000,75680,45,73,61.64383561643836,37,0,28,8
2961-961-0021,79040,39,77,50.649350649350644,19,1,37,20
7021-79730-0001,183840,125,179,69.83240223463687,97,1,53,28
2094-142345-0023,82880,61,80,76.25,46,1,18,15
1221-135766-0005,266320,111,259,42.857142857142854,71,0,148,40
1188-133604-0039,106000,66,103,64.07766990291263,42,2,35,24
7176-92135-0016,120720,97,117,82.90598290598291,82,1,19,15
7176-92135-0017,114720,92,111,82.88288288288288,79,0,19,13
7176-88083-0014,74720,46,72,63.888888888888886,35,1,25,11
5683-32865-0013,113520,72,110,65.45454545454545,35,3,35,37
121-121726-0007,107680,67,105,63.8095238095238,36,1,37,31
908-31957-0004,236080,171,230,74.34782608695653,117,1,58,54
1221-135766-0012,259520,109,253,43.08300395256917,58,0,144,51
7127-75947-0036,39040,24,38,63.1578947368421,12,1,13,12
2094-142345-0003,234800,194,229,84.71615720524017,124,6,29,70
1188-133604-0028,304080,220,296,74.32432432432432,132,5,71,88
1995-1837-0015,71760,45,70,64.28571428571429,41,0,25,4
6930-81414-0018,46880,17,45,37.77777777777778,4,0,28,13
1284-1181-0010,102960,78,100,78.0,65,2,20,13
4992-23283-0003,74320,44,72,61.111111111111114,29,0,28,15
2300-131720-0041,60000,43,58,74.13793103448276,34,3,12,9
4992-41806-0007,182640,119,178,66.85393258426966,85,1,58,34
7127-75947-0019,62000,42,60,70.0,16,1,17,26
1320-122617-0015,82000,58,80,72.5,39,0,22,19
7127-75946-0016,179360,105,174,60.3448275862069,64,2,67,41
5105-28241-0004,278640,150,271,55.35055350553506,98,1,120,52
6829-68769-0007,61840,45,60,75.0,36,1,14,9
5683-32866-0001,55520,37,54,68.51851851851852,24,0,17,13
2094-142345-0051,84960,66,82,80.48780487804879,43,2,14,23
1580-141083-0014,45680,24,44,54.54545454545454,8,0,20,16
908-157963-0015,231440,171,225,76.0,116,3,51,55
4970-29095-0024,96640,53,94,56.38297872340425,36,0,41,17
1284-1181-0020,107680,77,105,73.33333333333333,58,2,26,19
1221-135767-0009,213440,110,208,52.88461538461539,64,1,97,46
3729-6852-0024,88240,53,86,61.627906976744185,34,0,33,19
7127-75947-0029,84560,53,82,64.63414634146342,36,1,28,17
3729-6852-0007,199840,95,194,48.96907216494845,49,1,98,46
1320-122617-0030,63680,52,62,83.87096774193549,33,1,9,19
4507-16021-0046,73440,47,71,66.19718309859155,36,0,24,11
4507-16021-0054,69040,49,67,73.13432835820896,33,0,18,16
121-121726-0013,39840,25,38,65.78947368421053,12,2,11,13
2830-3979-0011,151200,99,147,67.3469387755102,53,3,45,46
908-31957-0012,121840,91,118,77.11864406779661,61,3,24,30
8455-210777-0009,73280,64,71,90.14084507042254,36,0,7,28
3575-170457-0001,47840,35,46,76.08695652173914,27,1,10,8
2961-961-0020,98000,44,95,46.31578947368421,28,2,49,16
7176-92135-0042,116320,93,113,82.30088495575221,84,2,18,9
1089-134691-0022,90160,56,87,64.36781609195403,41,1,30,15
4507-16021-0010,242640,143,236,60.59322033898306,100,2,91,43
260-123288-0021,43360,33,42,78.57142857142857,21,0,9,12
4507-16021-0040,62800,39,61,63.934426229508205,21,0,22,18
672-122797-0048,104880,71,102,69.6078431372549,30,3,28,41
1580-141083-0018,42800,22,41,53.65853658536586,9,2,17,13
260-123440-0013,55600,42,54,77.77777777777779,35,0,12,7
1284-1180-0026,132640,92,129,71.31782945736434,77,0,37,15
4507-16021-0019,46880,33,45,73.33333333333333,19,0,12,14
6930-81414-0021,51600,23,50,46.0,9,3,24,14
260-123286-0030,120480,79,117,67.52136752136752,59,3,35,20
7176-92135-0008,70880,53,69,76.81159420289855,46,1,15,7
8455-210777-0063,36160,31,35,88.57142857142857,15,0,4,16
1580-141084-0010,71520,35,69,50.72463768115942,13,1,33,22
8455-210777-0034,123200,96,120,80.0,67,3,21,29
2094-142345-0056,61440,41,59,69.49152542372882,30,0,18,11
672-122797-0036,85840,43,83,51.80722891566265,23,2,38,20
4970-29093-0003,245680,117,239,48.95397489539749,62,6,116,55
672-122797-0074,139680,84,136,61.76470588235294,19,12,40,65
7176-92135-0030,35760,32,34,94.11764705882352,21,0,2,11
908-31957-0008,160080,123,156,78.84615384615384,75,0,33,48
908-157963-0017,79200,60,77,77.92207792207793,41,0,17,19
4446-2273-0029,52800,21,51,41.17647058823529,8,0,30,13
3729-6852-0035,330400,157,322,48.75776397515528,81,6,159,76
5639-40744-0020,157120,80,153,52.28758169934641,39,0,73,41
61-70970-0008,34400,31,33,93.93939393939394,22,0,2,9
5142-33396-0034,105840,48,103,46.601941747572816,27,2,53,21
121-121726-0014,50640,35,49,71.42857142857143,13,2,12,22
8230-279154-0023,100240,65,97,67.0103092783505,52,1,31,13
237-134500-0040,64480,45,62,72.58064516129032,32,1,16,13
3570-5695-0015,127200,93,124,75.0,77,0,31,16
7729-102255-0037,176320,124,172,72.09302325581395,99,1,47,25
1320-122617-0002,217360,169,212,79.71698113207547,141,2,41,28
5142-36377-0013,105360,41,102,40.19607843137255,35,2,59,6
3729-6852-0017,287840,148,280,52.85714285714286,95,3,129,53
8230-279154-0019,290320,194,283,68.55123674911661,153,0,89,41
8230-279154-0010,243040,162,237,68.35443037974683,128,0,75,34
4446-2275-0029,100480,54,98,55.10204081632652,32,2,42,22
908-157963-0010,100480,68,98,69.38775510204081,40,1,29,28
2094-142345-0001,128480,109,125,87.2,73,2,14,36
4446-2275-0012,96400,46,94,48.93617021276596,24,2,46,22
260-123286-0005,76960,51,75,68.0,34,0,24,17
5105-28240-0018,46160,36,45,80.0,25,0,9,11
