signal_name, length, matches, checks, pc_accuracy, psas, psan, pnas, pnan
672-122797-0000,65120,44,63,69.84126984126983,27,0,19,17
1995-1837-0023,271440,109,264,41.28787878787879,72,0,155,37
260-123288-0024,233520,83,227,36.56387665198238,47,0,144,36
5683-32879-0013,183920,80,179,44.6927374301676,44,0,99,36
6829-68771-0018,135120,66,131,50.38167938931297,42,1,64,24
6930-75918-0018,172960,105,168,62.5,80,1,62,25
1284-1180-0028,96720,67,94,71.27659574468085,58,3,24,9
237-134493-0010,46000,26,44,59.09090909090909,16,0,18,10
7176-92135-0033,35680,16,34,47.05882352941176,11,0,18,5
2961-960-0002,245600,161,239,67.36401673640168,123,5,73,38
8455-210777-0022,261760,148,255,58.03921568627452,91,2,105,57
4077-13751-0000,152960,74,149,49.664429530201346,54,0,75,20
5639-40744-0002,142560,83,139,59.71223021582733,53,1,55,30
4970-29093-0019,119520,69,116,59.48275862068966,43,2,45,26
1284-1181-0005,61680,44,60,73.33333333333333,34,0,16,10
5683-32866-0007,65920,35,64,54.6875,21,0,29,14
5683-32866-0017,73360,37,71,52.112676056338024,22,0,34,15
3575-170457-0009,107680,54,105,51.42857142857142,34,0,51,20
5142-33396-0015,68960,47,67,70.1492537313433,38,1,19,9
1320-122617-0037,114880,53,112,47.32142857142857,40,0,59,13
2094-142345-0055,42480,21,41,51.21951219512195,11,0,20,10
3575-170457-0029,96880,52,94,55.319148936170215,34,0,42,18
2094-142345-0054,90880,51,88,57.95454545454546,20,0,37,31
672-122797-0051,74640,44,72,61.111111111111114,28,0,28,16
2300-131720-0026,281520,115,274,41.97080291970803,70,0,159,45
4507-16021-0034,180320,93,175,53.142857142857146,57,1,81,36
7127-75946-0025,63360,45,61,73.77049180327869,23,0,16,22
8555-284447-0007,101840,68,99,68.68686868686868,49,0,31,19
4077-13754-0016,190320,119,185,64.32432432432432,78,2,64,41
5105-28240-0004,96240,46,93,49.46236559139785,27,0,47,19
4507-16021-0049,94560,50,92,54.347826086956516,34,0,42,16
6829-68769-0024,79120,38,77,49.35064935064935,26,0,39,12
7176-92135-0005,87520,37,85,43.529411764705884,23,0,48,14
8463-294825-0004,58880,33,57,57.89473684210527,25,1,23,8
260-123440-0007,54160,28,52,53.84615384615385,18,0,24,10
4446-2273-0035,98400,51,96,53.125,27,0,45,24
908-31957-0025,328960,205,320,64.0625,68,0,115,137
1284-1180-0019,240400,167,234,71.36752136752136,145,4,63,22
2830-3980-0024,62960,29,61,47.540983606557376,15,0,32,14
7176-92135-0024,65600,29,64,45.3125,18,0,35,11
61-70968-0022,74720,43,72,59.72222222222222,34,0,29,9
4992-23283-0008,78560,44,76,57.89473684210527,28,1,31,16
672-122797-0016,147440,98,143,68.53146853146853,57,0,45,41
237-134493-0015,104800,56,102,54.90196078431373,42,0,46,14
1089-134686-0003,42880,28,41,68.29268292682927,17,0,13,11
908-31957-0023,136240,73,132,55.3030303030303,26,0,59,47
121-123852-0004,260640,199,254,78.34645669291339,127,1,54,72
237-126133-0020,35840,23,34,67.64705882352942,15,0,11,8
1320-122617-0031,100560,50,98,51.02040816326531,34,0,48,16
4446-2275-0021,80800,44,78,56.41025641025641,14,0,34,30
1284-1180-0004,68560,35,66,53.03030303030303,27,0,31,8
7021-79730-0006,181440,80,177,45.19774011299435,41,1,96,39
1089-134691-0015,54320,38,52,73.07692307692307,10,0,14,28
672-122797-0065,48480,33,47,70.2127659574468,18,0,14,15
2961-960-0005,165680,120,161,74.53416149068323,81,1,40,39
7176-88083-0007,228800,83,223,37.219730941704036,52,0,140,31
7176-92135-0004,38800,20,37,54.054054054054056,12,0,17,8
5683-32866-0023,43920,20,42,47.61904761904761,9,0,22,11
7021-79740-0009,58160,25,56,44.642857142857146,17,0,31,8
7729-102255-0030,116000,58,113,51.32743362831859,34,0,55,24
908-157963-0006,129760,77,126,61.111111111111114,48,0,49,29
260-123288-0020,46400,22,45,48.888888888888886,11,0,23,11
2830-3980-0060,42800,13,41,31.70731707317073,5,0,28,8
1221-135767-0005,93840,43,91,47.25274725274725,18,0,48,25
1221-135767-0006,328960,149,320,46.5625,95,1,170,54
2830-3979-0001,258000,118,251,47.01195219123506,67,0,133,51
7176-92135-0036,103520,40,100,40.0,29,0,60,11
7021-85628-0026,43840,20,42,47.61904761904761,10,0,22,10
5142-33396-0029,34160,26,33,78.78787878787878,20,0,7,6
8230-279154-0039,73440,26,71,36.61971830985916,12,0,45,14
4446-2271-0008,87920,33,85,38.82352941176471,24,0,52,9
1089-134686-0034,92960,38,90,42.22222222222222,13,0,52,25
6930-75918-0017,98560,72,96,75.0,57,1,23,15
7729-102255-0043,176560,79,172,45.93023255813954,49,0,93,30
5683-32866-0022,51040,23,49,46.93877551020408,9,0,26,14
7127-75947-0021,63920,43,62,69.35483870967742,25,0,19,18
1089-134686-0011,199120,99,194,51.03092783505154,67,0,95,32
1089-134691-0012,240480,108,234,46.15384615384615,59,0,126,49
7021-79759-0005,208320,86,203,42.364532019704434,46,1,116,40
1580-141084-0006,34160,15,33,45.45454545454545,8,0,18,7
1580-141084-0021,64160,31,62,50.0,17,0,31,14
6930-76324-0008,82960,58,80,72.5,49,0,22,9
2830-3980-0073,264960,84,258,32.55813953488372,29,0,174,55
6829-68769-0009,67520,33,65,50.76923076923077,21,0,32,12
8463-294828-0019,72480,44,70,62.857142857142854,34,0,26,10
1221-135766-0002,77200,33,75,44.0,10,1,41,23
7127-75947-0014,161840,93,157,59.23566878980891,61,0,64,32
237-134500-0033,101600,58,99,58.58585858585859,25,1,40,33
5683-32879-0016,162960,73,158,46.20253164556962,39,1,84,34
8455-210777-0042,76480,38,74,51.35135135135135,23,1,35,15
2961-960-0015,125280,84,122,68.85245901639344,58,1,37,26
5683-32866-0030,77520,34,75,45.33333333333333,14,0,41,20
6930-75918-0019,186320,132,181,72.92817679558011,111,0,49,21
7021-79740-0000,178000,80,173,46.24277456647399,51,1,92,29
8455-210777-0054,40320,27,39,69.23076923076923,12,0,12,15
2094-142345-0000,361120,198,352,56.25,119,1,153,79
5105-28233-0007,418240,187,408,45.83333333333333,100,2,219,87
2300-131720-0010,173120,76,168,45.23809523809524,46,0,92,30
8555-284447-0006,207280,121,202,59.900990099009896,93,7,74,28
1320-122617-0038,35840,13,34,38.23529411764706,6,0,21,7
121-127105-0021,32000,10,31,32.25806451612903,4,0,21,6
8463-294825-0013,282240,154,275,56.00000000000001,113,1,120,41
6930-75918-0003,373040,254,363,69.9724517906336,202,5,104,52
3570-5695-0013,74240,38,72,52.77777777777778,29,0,34,9
5142-36586-0001,35440,23,34,67.64705882352942,18,1,10,5
2094-142345-0021,85360,60,83,72.28915662650603,39,0,23,21
7176-92135-0044,82800,20,80,25.0,12,0,60,8
5639-40744-0028,196000,102,191,53.403141361256544,48,0,89,54
8230-279154-0000,140880,51,137,37.22627737226277,32,0,86,19
4992-41806-0003,147840,66,144,45.83333333333333,42,0,78,24
8463-294828-0025,31840,19,31,61.29032258064516,13,1,11,6
6829-68771-0014,76320,41,74,55.4054054054054,26,0,33,15
7021-85628-0004,44880,20,43,46.51162790697674,6,0,23,14
2300-131720-0039,38160,26,37,70.27027027027027,12,0,11,14
237-134500-0017,34880,21,34,61.76470588235294,16,0,13,5
5142-36377-0006,74160,48,72,66.66666666666666,40,0,24,8
8230-279154-0037,328560,117,320,36.5625,63,1,202,54
4992-23283-0017,229040,119,223,53.36322869955157,84,0,104,35
4507-16021-0025,147440,84,143,58.74125874125874,40,1,58,44
2300-131720-0004,318560,140,310,45.16129032258064,94,1,169,46
237-134500-0016,50560,29,49,59.183673469387756,14,0,20,15
2830-3980-0069,88880,30,86,34.883720930232556,15,0,56,15
5142-33396-0050,46160,30,45,66.66666666666666,24,1,14,6
4507-16021-0004,34160,21,33,63.63636363636363,10,0,12,11
8463-294828-0003,149440,85,145,58.620689655172406,59,0,60,26
4970-29093-0021,38800,24,37,64.86486486486487,12,0,13,12
7127-75947-0010,141840,84,138,60.86956521739131,63,2,52,21
4077-13751-0020,164720,78,160,48.75,54,1,81,24
1995-1837-0008,31280,14,30,46.666666666666664,9,0,16,5
8463-294828-0017,148800,83,145,57.24137931034483,59,1,61,24
4507-16021-0014,97840,66,95,69.47368421052632,25,0,29,41
8455-210777-0047,40640,22,39,56.41025641025641,9,0,17,13
2094-142345-0032,51840,20,50,40.0,11,0,30,9
7021-85628-0015,184720,87,180,48.333333333333336,48,0,93,39
6829-68769-0003,67440,32,65,49.23076923076923,25,0,33,7
260-123440-0000,34640,16,33,48.484848484848484,8,0,17,8
8555-284447-0017,185920,112,181,61.87845303867403,86,0,69,26
7176-92135-0028,53520,17,52,32.69230769230769,11,0,35,6
4970-29095-0031,240800,150,234,64.1025641025641,101,1,83,49
7021-85628-0009,136640,60,133,45.11278195488722,39,0,73,21
8463-294828-0012,78480,52,76,68.42105263157895,35,1,23,17
237-134500-0003,50720,23,49,46.93877551020408,14,0,26,9
8463-294828-0029,84560,52,82,63.41463414634146,31,0,30,21
2830-3980-0062,87040,36,84,42.857142857142854,12,0,48,24
260-123286-0022,51760,24,50,48.0,13,0,26,11
7021-79740-0013,117840,63,114,55.26315789473685,43,1,50,20
5105-28233-0002,132560,62,129,48.06201550387597,39,0,67,23
8224-274384-0002,157040,55,153,35.947712418300654,28,0,98,27
4970-29093-0011,183200,116,178,65.1685393258427,71,2,60,45
1995-1837-0014,199360,91,194,46.90721649484536,63,1,102,28
8230-279154-0032,62080,22,60,36.666666666666664,10,0,38,12
61-70970-0000,97200,31,94,32.97872340425532,21,0,63,10
260-123288-0014,28880,12,28,42.857142857142854,3,0,16,9
1188-133604-0034,334480,135,326,41.41104294478527,48,0,191,87
4446-2275-0038,72480,39,70,55.714285714285715,26,1,30,13
8463-287645-0011,102080,52,99,52.52525252525253,34,0,47,18
5105-28233-0003,236960,112,231,48.484848484848484,76,0,119,36
672-122797-0047,53200,36,51,70.58823529411765,25,0,15,11
8555-292519-0002,28960,21,28,75.0,5,0,7,16
1089-134686-0032,65440,38,63,60.317460317460316,20,0,25,18
8230-279154-0022,103040,33,100,33.0,15,0,67,18
2300-131720-0022,218640,108,213,50.70422535211267,75,1,104,33
6829-68771-0023,86800,51,84,60.71428571428571,29,0,33,22
5142-36586-0000,58400,42,56,75.0,30,0,14,12
1284-1180-0001,124080,84,121,69.42148760330579,68,1,36,16
4446-2273-0036,49920,30,48,62.5,17,0,18,13
4507-16021-0007,42080,27,41,65.85365853658537,16,0,14,11
4970-29095-0038,139840,79,136,58.08823529411765,51,0,57,28
7176-88083-0005,75200,29,73,39.726027397260275,18,0,44,11
1580-141083-0043,43840,23,42,54.761904761904766,11,0,19,12
3575-170457-0018,46720,27,45,60.0,3,0,18,24
1580-141083-0024,71680,38,69,55.072463768115945,17,0,31,21
1580-141083-0007,73040,38,71,53.52112676056338,26,1,32,12
1089-134686-0036,52000,20,50,40.0,10,0,30,10
3729-6852-0022,133040,72,129,55.81395348837209,42,0,57,30
2300-131720-0034,137680,65,134,48.507462686567166,48,1,68,17
4077-13751-0004,266880,136,260,52.307692307692314,92,1,123,44
8455-210777-0016,259840,171,253,67.58893280632411,115,0,82,56
2830-3979-0010,53760,22,52,42.30769230769231,6,0,30,16
6829-68769-0002,49200,27,48,56.25,18,0,21,9
4992-23283-0002,49920,21,48,43.75,7,0,27,14
1284-1180-0011,68400,44,66,66.66666666666666,31,0,22,13
5105-28240-0023,281120,133,274,48.54014598540146,79,0,141,54
7176-88083-0020,86640,26,84,30.952380952380953,17,0,58,9
7729-102255-0021,126880,58,123,47.15447154471545,35,0,65,23
5639-40744-0012,137520,69,134,51.49253731343284,47,1,64,22
6930-75918-0008,76560,59,74,79.72972972972973,37,0,15,22
8463-294825-0009,320080,170,312,54.48717948717948,127,4,138,43
7127-75946-0026,322400,187,314,59.554140127388536,132,0,127,55
8463-294828-0018,47120,29,45,64.44444444444444,10,1,15,19
1320-122617-0029,126000,58,122,47.540983606557376,41,0,64,17
1580-141083-0005,43920,16,42,38.095238095238095,4,0,26,12
237-126133-0019,113920,66,111,59.45945945945946,44,1,44,22
4970-29095-0013,31680,24,30,80.0,7,0,6,17
7176-88083-0017,58560,18,57,31.57894736842105,13,0,39,5
5105-28240-0017,90640,47,88,53.40909090909091,29,0,41,18
4446-2275-0041,76080,42,74,56.75675675675676,27,1,31,15
121-123852-0002,276560,211,269,78.43866171003717,132,2,56,79
237-134500-0031,169760,93,165,56.36363636363636,66,0,72,27
1188-133604-0018,184800,65,180,36.11111111111111,35,0,115,30
3575-170457-0021,66880,35,65,53.84615384615385,22,0,30,13
5639-40744-0040,200160,107,195,54.871794871794876,72,0,88,35
8555-284449-0019,121760,69,118,58.47457627118644,48,0,49,21
672-122797-0004,164000,120,160,75.0,73,0,40,47
6829-68771-0002,143040,72,139,51.798561151079134,54,0,67,18
4077-13754-0007,223200,128,217,58.986175115207374,92,1,88,36
2094-142345-0026,45200,26,44,59.09090909090909,15,0,18,11
8463-294825-0006,178160,110,173,63.58381502890174,88,1,62,22
121-127105-0009,36640,12,35,34.285714285714285,8,0,23,4
5639-40744-0025,140560,82,137,59.854014598540154,48,1,54,34
6930-76324-0005,80560,54,78,69.23076923076923,42,2,22,12
5683-32879-0023,79600,44,77,57.14285714285714,29,0,33,15
1089-134686-0006,168880,86,164,52.4390243902439,53,0,78,33
7127-75946-0013,137280,73,133,54.88721804511278,39,0,60,34
4446-2273-0030,46160,29,45,64.44444444444444,16,0,16,13
4507-16021-0015,61760,35,60,58.333333333333336,18,0,25,17
3570-5694-0013,89760,45,87,51.724137931034484,34,0,42,11
2094-142345-0018,50480,35,49,71.42857142857143,25,0,14,10
4970-29093-0023,129120,87,125,69.6,59,0,38,28
5142-36377-0021,301920,180,294,61.224489795918366,154,2,112,26
6829-68771-0006,94720,49,92,53.2608695652174,36,0,43,13
7127-75947-0032,75920,52,74,70.27027027027027,13,0,22,39
672-122797-0054,68000,46,66,69.6969696969697,23,0,20,23
7021-79740-0012,52160,28,50,56.00000000000001,13,0,22,15
1995-1837-0001,139680,43,136,31.61764705882353,24,1,92,19
1284-1181-0021,43200,22,42,52.38095238095239,16,2,18,6
1580-141084-0050,44480,22,43,51.162790697674424,13,0,21,9
61-70968-0031,46800,24,45,53.333333333333336,17,0,21,7
3729-6852-0011,117920,53,115,46.08695652173913,32,0,62,21
260-123286-0014,47680,20,46,43.47826086956522,6,0,26,14
1089-134686-0004,83440,50,81,61.72839506172839,25,0,31,25
5142-33396-0011,56320,37,54,68.51851851851852,30,0,17,7
4970-29095-0009,89600,50,87,57.47126436781609,26,0,37,24
1188-133604-0020,164160,67,160,41.875,20,0,93,47
2830-3980-0076,76960,28,75,37.333333333333336,12,0,47,16
2961-960-0013,169200,118,165,71.51515151515152,86,5,42,32
7127-75946-0023,59920,41,58,70.6896551724138,24,0,17,17
5683-32879-0014,134480,57,131,43.51145038167939,32,0,74,25
237-134493-0002,182320,103,177,58.19209039548022,63,0,74,40
5105-28241-0015,466240,230,454,50.66079295154186,132,1,223,98
5142-36377-0020,72480,44,70,62.857142857142854,39,0,26,5
61-70968-0018,38480,24,37,64.86486486486487,13,0,13,11
8230-279154-0034,232160,73,226,32.30088495575221,30,1,152,43
7021-79730-0002,43040,24,41,58.536585365853654,5,0,17,19
5142-33396-0046,59920,34,58,58.620689655172406,28,0,24,6
908-31957-0024,120640,77,117,65.8119658119658,32,0,40,45
121-121726-0005,49600,37,48,77.08333333333334,6,0,11,31
61-70968-0003,69040,37,67,55.223880597014926,21,0,30,16
1995-1837-0026,129520,71,126,56.34920634920635,50,0,55,21
8224-274381-0007,161360,63,157,40.12738853503185,30,0,94,33
4507-16021-0056,101520,59,99,59.59595959595959,28,3,37,31
4970-29093-0007,111920,84,109,77.06422018348624,49,1,24,35
4992-41806-0008,189120,86,184,46.73913043478261,48,1,97,38
908-157963-0029,58080,32,56,57.14285714285714,18,1,23,14
237-134500-0026,48800,34,47,72.3404255319149,20,0,13,14
2830-3980-0070,59680,32,58,55.172413793103445,6,0,26,26
2094-142345-0013,228000,105,222,47.2972972972973,59,0,117,46
6930-81414-0009,192240,126,187,67.37967914438502,94,6,55,32
6829-68769-0023,78240,39,76,51.31578947368421,26,1,36,13
672-122797-0015,71280,40,69,57.971014492753625,31,0,29,9
3729-6852-0015,41760,20,40,50.0,2,0,20,18
260-123286-0008,59760,20,58,34.48275862068966,9,0,38,11
1284-1181-0002,61360,36,59,61.016949152542374,25,0,23,11
237-134493-0012,58560,34,57,59.64912280701754,23,0,23,11
61-70968-0032,68480,30,66,45.45454545454545,15,0,36,15
5683-32865-0016,48960,31,47,65.95744680851064,20,0,16,11
8224-274381-0013,217760,92,212,43.39622641509434,50,1,119,42
1995-1836-0000,143280,50,139,35.97122302158273,35,0,89,15
5142-33396-0047,40560,26,39,66.66666666666666,20,0,13,6
7729-102255-0045,108880,55,106,51.886792452830186,33,1,50,22
3575-170457-0010,76640,40,74,54.054054054054056,28,0,34,12
7729-102255-0017,241760,106,235,45.1063829787234,68,0,129,38
1284-1181-0000,63440,41,61,67.21311475409836,30,0,20,11
3570-5695-0006,119520,59,116,50.86206896551724,47,0,57,12
2830-3980-0053,80240,35,78,44.871794871794876,12,0,43,23
4446-2275-0006,56640,29,55,52.72727272727272,23,0,26,6
8463-287645-0009,59360,21,57,36.84210526315789,15,0,36,6
5142-33396-0016,34640,20,33,60.60606060606061,14,0,13,6
7176-92135-0014,256320,115,250,46.0,84,0,135,31
8224-274381-0011,103680,41,101,40.5940594059406,18,0,60,23
7127-75947-0026,104880,70,102,68.62745098039215,45,0,32,25
260-123286-0007,72800,37,71,52.112676056338024,24,0,34,13
8224-274381-0000,283840,111,276,40.21739130434783,52,0,165,59
2830-3980-0022,52320,20,51,39.21568627450981,6,0,31,14
6829-68771-0000,213040,111,207,53.62318840579711,83,0,96,28
1320-122612-0011,219120,109,213,51.173708920187785,80,0,104,29
672-122797-0011,40640,19,39,48.717948717948715,15,0,20,4
7021-85628-0007,266800,121,260,46.53846153846154,68,2,137,53
260-123286-0025,147280,71,143,49.65034965034965,42,0,72,29
8455-210777-0010,49600,24,48,50.0,10,0,24,14
4992-41797-0006,72800,39,71,54.929577464788736,28,0,32,11
8555-292519-0005,153200,89,149,59.73154362416108,60,0,60,29
1221-135766-0004,119040,49,116,42.241379310344826,26,0,67,23
5639-40744-0021,175680,85,171,49.707602339181285,54,0,86,31
8463-287645-0014,48320,22,47,46.808510638297875,12,0,25,10
3570-5695-0008,109520,43,106,40.56603773584906,30,0,63,13
5639-40744-0016,151840,88,148,59.45945945945946,63,1,59,25
8463-294828-0028,126640,71,123,57.72357723577236,52,1,51,19
7729-102255-0023,88000,31,85,36.470588235294116,23,1,53,8
5683-32865-0006,53600,32,52,61.53846153846154,19,3,17,13
6829-68771-0035,70240,47,68,69.11764705882352,42,2,19,5
6829-68769-0028,52640,24,51,47.05882352941176,15,0,27,9
237-134493-0003,204240,106,199,53.266331658291456,83,0,93,23
1284-1181-0019,51200,34,49,69.38775510204081,29,0,15,5
8463-287645-0000,75680,25,73,34.24657534246575,17,0,48,8
2961-961-0021,79040,55,77,71.42857142857143,34,0,22,21
7021-79730-0001,183840,74,179,41.340782122905026,45,0,105,29
2094-142345-0023,82880,41,80,51.24999999999999,25,0,39,16
1221-135766-0005,266320,89,259,34.36293436293436,50,1,169,39
1188-133604-0039,106000,36,103,34.95145631067961,10,0,67,26
7176-92135-0016,120720,55,117,47.008547008547005,39,0,62,16
7176-92135-0017,114720,42,111,37.83783783783784,30,1,68,12
7176-88083-0014,74720,36,72,50.0,24,0,36,12
5683-32865-0013,113520,67,110,60.909090909090914,27,0,43,40
121-121726-0007,107680,55,105,52.38095238095239,23,0,50,32
908-31957-0004,236080,118,230,51.30434782608696,63,0,112,55
1221-135766-0012,259520,90,253,35.573122529644266,39,0,163,51
7127-75947-0036,39040,27,38,71.05263157894737,15,1,10,12
2094-142345-0003,234800,135,229,58.951965065502186,59,0,94,76
1188-133604-0028,304080,112,296,37.83783783783784,20,1,183,92
1995-1837-0015,71760,26,70,37.142857142857146,22,0,44,4
6930-81414-0018,46880,35,45,77.77777777777779,22,0,10,13
1284-1181-0010,102960,71,100,71.0,56,0,29,15
4992-23283-0003,74320,37,72,51.388888888888886,22,0,35,15
2300-131720-0041,60000,35,58,60.3448275862069,23,0,23,12
4992-41806-0007,182640,92,178,51.68539325842697,57,0,86,35
7127-75947-0019,62000,45,60,75.0,19,1,14,26
1320-122617-0015,82000,45,80,56.25,26,0,35,19
7127-75946-0016,179360,113,174,64.9425287356322,71,1,60,42
5105-28241-0004,278640,126,271,46.494464944649444,73,0,145,53
6829-68769-0007,61840,28,60,46.666666666666664,18,0,32,10
5683-32866-0001,55520,27,54,50.0,14,0,27,13
2094-142345-0051,84960,49,82,59.756097560975604,24,0,33,25
1580-141083-0014,45680,30,44,68.18181818181817,14,0,14,16
908-157963-0015,231440,128,225,56.888888888888886,70,0,97,58
4970-29095-0024,96640,51,94,54.25531914893617,34,0,43,17
1284-1181-0020,107680,72,105,68.57142857142857,53,2,31,19
1221-135767-0009,213440,101,208,48.55769230769231,54,0,107,47
3729-6852-0024,88240,39,86,45.348837209302324,21,1,46,18
7127-75947-0029,84560,58,82,70.73170731707317,40,0,24,18
3729-6852-0007,199840,98,194,50.51546391752577,51,0,96,47
1320-122617-0030,63680,31,62,50.0,11,0,31,20
4507-16021-0046,73440,41,71,57.74647887323944,30,0,30,11
4507-16021-0054,69040,38,67,56.71641791044776,22,0,29,16
121-121726-0013,39840,26,38,68.42105263157895,11,0,12,15
2830-3979-0011,151200,83,147,56.4625850340136,34,0,64,49
908-31957-0012,121840,84,118,71.1864406779661,52,1,33,32
8455-210777-0009,73280,53,71,74.64788732394366,25,0,18,28
3575-170457-0001,47840,25,46,54.347826086956516,16,0,21,9
2961-961-0020,98000,65,95,68.42105263157895,48,1,29,17
7176-92135-0042,116320,49,113,43.36283185840708,38,0,64,11
1089-134691-0022,90160,50,87,57.47126436781609,34,0,37,16
4507-16021-0010,242640,132,236,55.932203389830505,89,2,102,43
260-123288-0021,43360,20,42,47.61904761904761,8,0,22,12
4507-16021-0040,62800,36,61,59.01639344262295,20,2,23,16
672-122797-0048,104880,69,102,67.64705882352942,25,0,33,44
1580-141083-0018,42800,24,41,58.536585365853654,9,0,17,15
260-123440-0013,55600,15,54,27.77777777777778,8,0,39,7
1284-1180-0026,132640,87,129,67.44186046511628,74,2,40,13
4507-16021-0019,46880,25,45,55.55555555555556,11,0,20,14
6930-81414-0021,51600,35,50,70.0,22,4,11,13
260-123286-0030,120480,59,117,50.427350427350426,36,0,58,23
7176-92135-0008,70880,30,69,43.47826086956522,22,0,39,8
8455-210777-0063,36160,27,35,77.14285714285715,11,0,8,16
1580-141084-0010,71520,36,69,52.17391304347826,15,2,31,21
8455-210777-0034,123200,79,120,65.83333333333333,47,0,41,32
2094-142345-0056,61440,33,59,55.932203389830505,22,0,26,11
672-122797-0036,85840,53,83,63.85542168674698,33,2,28,20
4970-29093-0003,245680,155,239,64.85355648535564,98,4,80,57
672-122797-0074,139680,100,136,73.52941176470588,23,0,36,77
7176-92135-0030,35760,15,34,44.11764705882353,4,0,19,11
908-31957-0008,160080,100,156,64.1025641025641,52,0,56,48
908-157963-0017,79200,40,77,51.94805194805194,21,0,37,19
4446-2273-0029,52800,28,51,54.90196078431373,15,0,23,13
3729-6852-0035,330400,134,322,41.61490683229814,53,1,187,81
5639-40744-0020,157120,85,153,55.55555555555556,44,0,68,41
61-70970-0008,34400,23,33,69.6969696969697,14,0,10,9
5142-33396-0034,105840,67,103,65.0485436893204,47,3,33,20
121-121726-0014,50640,33,49,67.3469387755102,9,0,16,24
8230-279154-0023,100240,35,97,36.08247422680412,21,0,62,14
237-134500-0040,64480,37,62,59.67741935483871,23,0,25,14
3570-5695-0015,127200,51,124,41.12903225806452,35,0,73,16
7729-102255-0037,176320,74,172,43.02325581395349,49,1,97,25
1320-122617-0002,217360,99,212,46.69811320754717,69,0,113,30
5142-36377-0013,105360,63,102,61.76470588235294,55,0,39,8
3729-6852-0017,287840,129,280,46.07142857142857,73,0,151,56
8230-279154-0019,290320,92,283,32.50883392226148,51,0,191,41
8230-279154-0010,243040,72,237,30.37974683544304,38,0,165,34
4446-2275-0029,100480,62,98,63.26530612244898,38,0,36,24
908-157963-0010,100480,48,98,48.97959183673469,19,0,50,29
2094-142345-0001,128480,79,125,63.2,41,0,46,38
4446-2275-0012,96400,52,94,55.319148936170215,29,1,41,23
260-123286-0005,76960,40,75,53.333333333333336,23,0,35,17
5105-28240-0018,46160,26,45,57.77777777777777,15,0,19,11
