signal_name, length, matches, checks, pc_accuracy, psas, psan, pnas, pnan
672-122797-0000,65120,19,63,30.158730158730158,5,3,41,14
1995-1837-0023,271440,84,264,31.818181818181817,51,4,176,33
260-123288-0024,233520,71,227,31.277533039647576,36,1,155,35
5683-32879-0013,183920,58,179,32.402234636871505,23,1,120,35
6829-68771-0018,135120,46,131,35.11450381679389,22,1,84,24
6930-75918-0018,172960,49,168,29.166666666666668,25,2,117,24
1284-1180-0028,96720,24,94,25.53191489361702,14,2,68,10
237-134493-0010,46000,18,44,40.909090909090914,9,1,25,9
7176-92135-0033,35680,10,34,29.411764705882355,6,1,23,4
2961-960-0002,245600,72,239,30.125523012552303,36,7,160,36
8455-210777-0022,261760,86,255,33.72549019607843,33,6,163,53
4077-13751-0000,152960,42,149,28.187919463087248,24,2,105,18
5639-40744-0002,142560,46,139,33.093525179856115,18,3,90,28
4970-29093-0019,119520,38,116,32.758620689655174,14,4,74,24
1284-1181-0005,61680,23,60,38.333333333333336,13,0,37,10
5683-32866-0007,65920,24,64,37.5,12,2,38,12
5683-32866-0017,73360,22,71,30.985915492957744,9,2,47,13
3575-170457-0009,107680,37,105,35.23809523809524,18,1,67,19
5142-33396-0015,68960,17,67,25.37313432835821,8,1,49,9
1320-122617-0037,114880,34,112,30.357142857142854,22,1,77,12
2094-142345-0055,42480,15,41,36.58536585365854,6,1,25,9
3575-170457-0029,96880,25,94,26.595744680851062,9,2,67,16
2094-142345-0054,90880,46,88,52.27272727272727,16,1,41,30
672-122797-0051,74640,17,72,23.61111111111111,4,3,52,13
2300-131720-0026,281520,83,274,30.29197080291971,45,7,184,38
4507-16021-0034,180320,55,175,31.428571428571427,22,4,116,33
7127-75946-0025,63360,20,61,32.78688524590164,2,4,37,18
8555-284447-0007,101840,32,99,32.323232323232325,14,1,66,18
4077-13754-0016,190320,58,185,31.351351351351354,18,3,124,40
5105-28240-0004,96240,29,93,31.182795698924732,14,4,60,15
4507-16021-0049,94560,30,92,32.608695652173914,16,2,60,14
6829-68769-0024,79120,27,77,35.064935064935064,17,2,48,10
7176-92135-0005,87520,35,85,41.17647058823529,21,0,50,14
8463-294825-0004,58880,18,57,31.57894736842105,10,1,38,8
260-123440-0007,54160,13,52,25.0,5,2,37,8
4446-2273-0035,98400,27,96,28.125,8,5,64,19
908-31957-0025,328960,161,320,50.31250000000001,40,16,143,121
1284-1180-0019,240400,70,234,29.914529914529915,46,2,162,24
2830-3980-0024,62960,20,61,32.78688524590164,7,1,40,13
7176-92135-0024,65600,22,64,34.375,12,1,41,10
61-70968-0022,74720,19,72,26.38888888888889,11,1,52,8
4992-23283-0008,78560,22,76,28.947368421052634,5,0,54,17
672-122797-0016,147440,50,143,34.96503496503497,15,6,87,35
237-134493-0015,104800,38,102,37.254901960784316,25,1,63,13
1089-134686-0003,42880,16,41,39.02439024390244,5,0,25,11
908-31957-0023,136240,56,132,42.42424242424242,17,8,68,39
121-123852-0004,260640,84,254,33.07086614173229,20,9,161,64
237-126133-0020,35840,12,34,35.294117647058826,4,0,22,8
1320-122617-0031,100560,39,98,39.795918367346935,26,3,56,13
4446-2275-0021,80800,34,78,43.58974358974359,7,3,41,27
1284-1180-0004,68560,17,66,25.757575757575758,9,0,49,8
7021-79730-0006,181440,64,177,36.15819209039548,32,8,105,32
1089-134691-0015,54320,27,52,51.92307692307693,4,5,20,23
672-122797-0065,48480,15,47,31.914893617021278,2,2,30,13
2961-960-0005,165680,63,161,39.130434782608695,28,5,93,35
7176-88083-0007,228800,84,223,37.66816143497758,59,6,133,25
7176-92135-0004,38800,16,37,43.24324324324324,10,2,19,6
5683-32866-0023,43920,14,42,33.33333333333333,5,2,26,9
7021-79740-0009,58160,15,56,26.785714285714285,8,1,40,7
7729-102255-0030,116000,37,113,32.743362831858406,17,4,72,20
908-157963-0006,129760,36,126,28.57142857142857,13,6,84,23
260-123288-0020,46400,17,45,37.77777777777778,8,2,26,9
2830-3980-0060,42800,15,41,36.58536585365854,7,0,26,8
1221-135767-0005,93840,31,91,34.065934065934066,9,3,57,22
1221-135767-0006,328960,84,320,26.25,39,10,226,45
2830-3979-0001,258000,93,251,37.05179282868526,48,6,152,45
7176-92135-0036,103520,43,100,43.0,34,2,55,9
7021-85628-0026,43840,14,42,33.33333333333333,6,2,26,8
5142-33396-0029,34160,11,33,33.33333333333333,6,1,21,5
8230-279154-0039,73440,28,71,39.436619718309856,15,1,42,13
4446-2271-0008,87920,25,85,29.411764705882355,18,2,58,7
1089-134686-0034,92960,30,90,33.33333333333333,10,5,55,20
6930-75918-0017,98560,20,96,20.833333333333336,7,3,73,13
7729-102255-0043,176560,58,172,33.72093023255814,32,4,110,26
5683-32866-0022,51040,18,49,36.734693877551024,4,0,31,14
7127-75947-0021,63920,22,62,35.483870967741936,6,2,38,16
1089-134686-0011,199120,56,194,28.865979381443296,26,2,136,30
1089-134691-0012,240480,73,234,31.196581196581196,29,5,156,44
7021-79759-0005,208320,67,203,33.004926108374384,33,7,129,34
1580-141084-0006,34160,8,33,24.242424242424242,3,2,23,5
1580-141084-0021,64160,20,62,32.25806451612903,6,0,42,14
6930-76324-0008,82960,17,80,21.25,8,0,63,9
2830-3980-0073,264960,88,258,34.10852713178294,43,10,160,45
6829-68769-0009,67520,25,65,38.46153846153847,14,1,39,11
8463-294828-0019,72480,18,70,25.71428571428571,9,1,51,9
1221-135766-0002,77200,26,75,34.66666666666667,4,2,47,22
7127-75947-0014,161840,36,157,22.929936305732486,12,8,113,24
237-134500-0033,101600,41,99,41.41414141414141,12,5,53,29
5683-32879-0016,162960,43,158,27.21518987341772,12,4,111,31
8455-210777-0042,76480,27,74,36.486486486486484,15,4,43,12
2961-960-0015,125280,35,122,28.688524590163933,15,7,80,20
5683-32866-0030,77520,24,75,32.0,6,2,49,18
6930-75918-0019,186320,31,181,17.12707182320442,13,3,147,18
7021-79740-0000,178000,60,173,34.68208092485549,31,1,112,29
8455-210777-0054,40320,18,39,46.15384615384615,4,1,20,14
2094-142345-0000,361120,138,352,39.20454545454545,68,10,204,70
5105-28233-0007,418240,123,408,30.14705882352941,42,8,277,81
2300-131720-0010,173120,67,168,39.88095238095239,41,4,97,26
8555-284447-0006,207280,56,202,27.722772277227726,27,6,140,29
1320-122617-0038,35840,10,34,29.411764705882355,3,0,24,7
121-127105-0021,32000,6,31,19.35483870967742,1,1,24,5
8463-294825-0013,282240,84,275,30.545454545454547,48,6,185,36
6930-75918-0003,373040,93,363,25.6198347107438,40,4,266,53
3570-5695-0013,74240,22,72,30.555555555555557,13,0,50,9
5142-36586-0001,35440,10,34,29.411764705882355,4,0,24,6
2094-142345-0021,85360,33,83,39.75903614457831,15,3,47,18
7176-92135-0044,82800,31,80,38.75,23,0,49,8
5639-40744-0028,196000,71,191,37.17277486910995,23,6,114,48
8230-279154-0000,140880,41,137,29.927007299270077,24,2,94,17
4992-41806-0003,147840,36,144,25.0,15,3,105,21
8463-294828-0025,31840,11,31,35.483870967741936,4,0,20,7
6829-68771-0014,76320,23,74,31.08108108108108,11,3,48,12
7021-85628-0004,44880,10,43,23.25581395348837,3,7,26,7
2300-131720-0039,38160,19,37,51.35135135135135,6,1,17,13
237-134500-0017,34880,13,34,38.23529411764706,8,0,21,5
5142-36377-0006,74160,14,72,19.444444444444446,8,2,56,6
8230-279154-0037,328560,99,320,30.9375,51,7,214,48
4992-23283-0017,229040,51,223,22.869955156950674,24,8,164,27
4507-16021-0025,147440,54,143,37.76223776223776,17,8,81,37
2300-131720-0004,318560,143,310,46.12903225806452,99,3,164,44
237-134500-0016,50560,24,49,48.97959183673469,9,0,25,15
2830-3980-0069,88880,29,86,33.72093023255814,16,2,55,13
5142-33396-0050,46160,13,45,28.888888888888886,7,1,31,6
4507-16021-0004,34160,16,33,48.484848484848484,5,0,17,11
8463-294828-0003,149440,37,145,25.517241379310345,17,6,102,20
4970-29093-0021,38800,13,37,35.13513513513514,3,2,22,10
7127-75947-0010,141840,41,138,29.71014492753623,20,2,95,21
4077-13751-0020,164720,43,160,26.875,22,4,113,21
1995-1837-0008,31280,15,30,50.0,10,0,15,5
8463-294828-0017,148800,44,145,30.344827586206897,21,2,99,23
4507-16021-0014,97840,45,95,47.368421052631575,7,3,47,38
8455-210777-0047,40640,18,39,46.15384615384615,6,1,20,12
2094-142345-0032,51840,18,50,36.0,10,1,31,8
7021-85628-0015,184720,63,180,35.0,27,3,114,36
6829-68769-0003,67440,12,65,18.461538461538463,5,0,53,7
260-123440-0000,34640,11,33,33.33333333333333,4,1,21,7
8555-284447-0017,185920,49,181,27.071823204419886,27,4,128,22
7176-92135-0028,53520,25,52,48.07692307692308,20,1,26,5
4970-29095-0031,240800,72,234,30.76923076923077,30,8,154,42
7021-85628-0009,136640,46,133,34.58646616541353,29,4,83,17
8463-294828-0012,78480,28,76,36.84210526315789,14,4,44,14
237-134500-0003,50720,15,49,30.612244897959183,6,0,34,9
8463-294828-0029,84560,29,82,35.36585365853659,11,3,50,18
2830-3980-0062,87040,34,84,40.476190476190474,12,2,48,22
260-123286-0022,51760,19,50,38.0,11,3,28,8
7021-79740-0013,117840,41,114,35.96491228070175,22,2,71,19
5105-28233-0002,132560,41,129,31.782945736434108,20,2,86,21
8224-274384-0002,157040,51,153,33.33333333333333,28,4,98,23
4970-29093-0011,183200,50,178,28.08988764044944,10,7,121,40
1995-1837-0014,199360,50,194,25.773195876288657,25,4,140,25
8230-279154-0032,62080,22,60,36.666666666666664,12,2,36,10
61-70970-0000,97200,28,94,29.78723404255319,19,1,65,9
260-123288-0014,28880,11,28,39.285714285714285,2,0,17,9
1188-133604-0034,334480,118,326,36.19631901840491,42,11,197,76
4446-2275-0038,72480,24,70,34.285714285714285,10,0,46,14
8463-287645-0011,102080,26,99,26.262626262626267,12,4,69,14
5105-28233-0003,236960,63,231,27.27272727272727,31,4,164,32
672-122797-0047,53200,19,51,37.254901960784316,10,2,30,9
8555-292519-0002,28960,16,28,57.14285714285714,2,2,10,14
1089-134686-0032,65440,18,63,28.57142857142857,7,7,38,11
8230-279154-0022,103040,33,100,33.0,15,0,67,18
2300-131720-0022,218640,72,213,33.80281690140845,40,2,139,32
6829-68771-0023,86800,37,84,44.047619047619044,19,4,43,18
5142-36586-0000,58400,15,56,26.785714285714285,4,1,40,11
1284-1180-0001,124080,34,121,28.09917355371901,19,2,85,15
4446-2273-0036,49920,16,48,33.33333333333333,5,2,30,11
4507-16021-0007,42080,17,41,41.46341463414634,6,0,24,11
4970-29095-0038,139840,39,136,28.676470588235293,12,1,96,27
7176-88083-0005,75200,20,73,27.397260273972602,12,3,50,8
1580-141083-0043,43840,11,42,26.190476190476193,2,3,28,9
3575-170457-0018,46720,22,45,48.888888888888886,2,4,19,20
1580-141083-0024,71680,30,69,43.47826086956522,13,4,35,17
1580-141083-0007,73040,18,71,25.352112676056336,7,2,51,11
1089-134686-0036,52000,15,50,30.0,6,1,34,9
3729-6852-0022,133040,34,129,26.356589147286826,10,6,89,24
2300-131720-0034,137680,39,134,29.1044776119403,22,1,94,17
4077-13751-0004,266880,85,260,32.69230769230769,47,7,168,38
8455-210777-0016,259840,105,253,41.50197628458498,54,5,143,51
2830-3979-0010,53760,21,52,40.38461538461539,6,1,30,15
6829-68769-0002,49200,18,48,37.5,9,0,30,9
4992-23283-0002,49920,17,48,35.41666666666667,4,1,30,13
1284-1180-0011,68400,28,66,42.42424242424242,17,2,36,11
5105-28240-0023,281120,84,274,30.656934306569344,36,6,184,48
7176-88083-0020,86640,23,84,27.380952380952383,15,1,60,8
7729-102255-0021,126880,40,123,32.52032520325203,22,5,78,18
5639-40744-0012,137520,28,134,20.8955223880597,8,3,103,20
6930-75918-0008,76560,24,74,32.432432432432435,5,3,47,19
8463-294825-0009,320080,78,312,25.0,37,6,228,41
7127-75946-0026,322400,90,314,28.662420382165603,43,8,216,47
8463-294828-0018,47120,27,45,60.0,7,0,18,20
1320-122617-0029,126000,42,122,34.42622950819672,25,0,80,17
1580-141083-0005,43920,17,42,40.476190476190474,6,1,24,11
237-126133-0019,113920,34,111,30.630630630630627,13,2,75,21
4970-29095-0013,31680,18,30,60.0,2,1,11,16
7176-88083-0017,58560,18,57,31.57894736842105,14,1,38,4
5105-28240-0017,90640,27,88,30.681818181818183,11,2,59,16
4446-2275-0041,76080,22,74,29.72972972972973,7,1,51,15
121-123852-0002,276560,107,269,39.77695167286245,36,10,152,71
237-134500-0031,169760,51,165,30.909090909090907,30,6,108,21
1188-133604-0018,184800,53,180,29.444444444444446,29,6,121,24
3575-170457-0021,66880,24,65,36.92307692307693,12,1,40,12
5639-40744-0040,200160,58,195,29.743589743589745,26,3,134,32
8555-284449-0019,121760,31,118,26.27118644067797,14,4,83,17
672-122797-0004,164000,54,160,33.75,16,9,97,38
6829-68771-0002,143040,41,139,29.496402877697843,25,2,96,16
4077-13754-0007,223200,63,217,29.03225806451613,32,6,148,31
2094-142345-0026,45200,20,44,45.45454545454545,10,1,23,10
8463-294825-0006,178160,41,173,23.699421965317917,21,3,129,20
121-127105-0009,36640,10,35,28.57142857142857,6,0,25,4
5639-40744-0025,140560,35,137,25.547445255474454,7,7,95,28
6930-76324-0005,80560,20,78,25.64102564102564,9,3,55,11
5683-32879-0023,79600,20,77,25.97402597402597,7,2,55,13
1089-134686-0006,168880,50,164,30.48780487804878,22,5,109,28
7127-75946-0013,137280,46,133,34.58646616541353,14,2,85,32
4446-2273-0030,46160,15,45,33.33333333333333,5,3,27,10
4507-16021-0015,61760,25,60,41.66666666666667,9,1,34,16
3570-5694-0013,89760,24,87,27.586206896551722,13,0,63,11
2094-142345-0018,50480,17,49,34.69387755102041,8,1,31,9
4970-29093-0023,129120,35,125,28.000000000000004,14,7,83,21
5142-36377-0021,301920,61,294,20.74829931972789,37,4,229,24
6829-68771-0006,94720,27,92,29.347826086956523,17,3,62,10
7127-75947-0032,75920,40,74,54.054054054054056,6,5,29,34
672-122797-0054,68000,21,66,31.818181818181817,5,7,38,16
7021-79740-0012,52160,17,50,34.0,4,2,31,13
1995-1837-0001,139680,52,136,38.23529411764706,32,0,84,20
1284-1181-0021,43200,12,42,28.57142857142857,4,0,30,8
1580-141084-0050,44480,13,43,30.23255813953488,5,1,29,8
61-70968-0031,46800,12,45,26.666666666666668,5,0,33,7
3729-6852-0011,117920,34,115,29.565217391304348,16,3,78,18
260-123286-0014,47680,16,46,34.78260869565217,4,2,28,12
1089-134686-0004,83440,33,81,40.74074074074074,13,5,43,20
5142-33396-0011,56320,20,54,37.03703703703704,14,1,33,6
4970-29095-0009,89600,33,87,37.93103448275862,11,2,52,22
1188-133604-0020,164160,60,160,37.5,20,7,93,40
2830-3980-0076,76960,30,75,40.0,14,0,45,16
2961-960-0013,169200,61,165,36.96969696969697,27,3,101,34
7127-75946-0023,59920,23,58,39.6551724137931,8,2,33,15
5683-32879-0014,134480,42,131,32.06106870229007,19,2,87,23
237-134493-0002,182320,67,177,37.85310734463277,35,8,102,32
5105-28241-0015,466240,145,454,31.938325991189426,53,7,302,92
5142-36377-0020,72480,12,70,17.142857142857142,7,0,58,5
61-70968-0018,38480,17,37,45.94594594594595,7,1,19,10
8230-279154-0034,232160,74,226,32.743362831858406,34,4,148,40
7021-79730-0002,43040,24,41,58.536585365853654,6,1,16,18
5142-33396-0046,59920,20,58,34.48275862068966,14,0,38,6
908-31957-0024,120640,56,117,47.863247863247864,18,7,54,38
121-121726-0005,49600,32,48,66.66666666666666,3,2,14,29
61-70968-0003,69040,22,67,32.83582089552239,9,3,42,13
1995-1837-0026,129520,36,126,28.57142857142857,17,2,88,19
8224-274381-0007,161360,58,157,36.94267515923567,32,7,92,26
4507-16021-0056,101520,40,99,40.4040404040404,10,4,55,30
4970-29093-0007,111920,41,109,37.61467889908257,8,3,65,33
4992-41806-0008,189120,54,184,29.347826086956523,19,4,126,35
908-157963-0029,58080,26,56,46.42857142857143,14,3,27,12
237-134500-0026,48800,18,47,38.297872340425535,6,2,27,12
2830-3980-0070,59680,34,58,58.620689655172406,8,0,24,26
2094-142345-0013,228000,84,222,37.83783783783784,43,5,133,41
6930-81414-0009,192240,49,187,26.203208556149733,13,2,136,36
6829-68769-0023,78240,29,76,38.15789473684211,17,2,45,12
672-122797-0015,71280,18,69,26.08695652173913,10,1,50,8
3729-6852-0015,41760,19,40,47.5,2,1,20,17
260-123286-0008,59760,19,58,32.758620689655174,9,1,38,10
1284-1181-0002,61360,27,59,45.76271186440678,17,1,31,10
237-134493-0012,58560,26,57,45.614035087719294,16,1,30,10
61-70968-0032,68480,24,66,36.36363636363637,11,2,40,13
5683-32865-0016,48960,16,47,34.04255319148936,6,1,30,10
8224-274381-0013,217760,80,212,37.735849056603776,45,8,124,35
1995-1836-0000,143280,38,139,27.33812949640288,23,0,101,15
5142-33396-0047,40560,9,39,23.076923076923077,4,1,29,5
7729-102255-0045,108880,29,106,27.358490566037734,10,4,73,19
3575-170457-0010,76640,29,74,39.189189189189186,19,2,43,10
7729-102255-0017,241760,69,235,29.361702127659573,39,8,158,30
1284-1181-0000,63440,29,61,47.540983606557376,19,1,31,10
3570-5695-0006,119520,34,116,29.310344827586203,22,0,82,12
2830-3980-0053,80240,31,78,39.743589743589745,11,3,44,20
4446-2275-0006,56640,17,55,30.909090909090907,12,1,37,5
8463-287645-0009,59360,15,57,26.31578947368421,9,0,42,6
5142-33396-0016,34640,13,33,39.39393939393939,7,0,20,6
7176-92135-0014,256320,86,250,34.4,59,4,160,27
8224-274381-0011,103680,42,101,41.584158415841586,22,3,56,20
7127-75947-0026,104880,35,102,34.31372549019608,10,0,67,25
260-123286-0007,72800,28,71,39.436619718309856,16,1,42,12
8224-274381-0000,283840,105,276,38.04347826086957,56,10,161,49
2830-3980-0022,52320,17,51,33.33333333333333,3,0,34,14
6829-68771-0000,213040,61,207,29.468599033816425,39,6,140,22
1320-122612-0011,219120,66,213,30.985915492957744,39,2,145,27
672-122797-0011,40640,9,39,23.076923076923077,5,0,30,4
7021-85628-0007,266800,86,260,33.07692307692307,40,9,165,46
260-123286-0025,147280,51,143,35.66433566433567,25,3,89,26
8455-210777-0010,49600,18,48,37.5,4,0,30,14
4992-41797-0006,72800,17,71,23.943661971830984,9,3,51,8
8555-292519-0005,153200,43,149,28.859060402684566,18,4,102,25
1221-135766-0004,119040,29,116,25.0,13,7,80,16
5639-40744-0021,175680,41,171,23.976608187134502,13,3,127,28
8463-287645-0014,48320,16,47,34.04255319148936,6,0,31,10
3570-5695-0008,109520,24,106,22.641509433962266,13,2,80,11
5639-40744-0016,151840,45,148,30.405405405405407,19,0,103,26
8463-294828-0028,126640,35,123,28.455284552845526,19,4,84,16
7729-102255-0023,88000,23,85,27.058823529411764,14,0,62,9
5683-32865-0006,53600,19,52,36.53846153846153,5,2,31,14
6829-68771-0035,70240,14,68,20.588235294117645,10,3,51,4
6829-68769-0028,52640,18,51,35.294117647058826,9,0,33,9
237-134493-0003,204240,54,199,27.1356783919598,35,4,141,19
1284-1181-0019,51200,13,49,26.53061224489796,9,1,35,4
8463-287645-0000,75680,23,73,31.506849315068493,16,1,49,7
2961-961-0021,79040,28,77,36.36363636363637,9,2,47,19
7021-79730-0001,183840,58,179,32.402234636871505,31,2,119,27
2094-142345-0023,82880,26,80,32.5,10,0,54,16
1221-135766-0005,266320,65,259,25.096525096525095,29,4,190,36
1188-133604-0039,106000,42,103,40.77669902912621,18,2,59,24
7176-92135-0016,120720,51,117,43.58974358974359,38,3,63,13
7176-92135-0017,114720,50,111,45.04504504504504,40,3,58,10
7176-88083-0014,74720,28,72,38.88888888888889,17,1,43,11
5683-32865-0013,113520,49,110,44.54545454545455,15,6,55,34
121-121726-0007,107680,45,105,42.857142857142854,15,2,58,30
908-31957-0004,236080,92,230,40.0,45,8,130,47
1221-135766-0012,259520,73,253,28.85375494071146,28,6,174,45
7127-75947-0036,39040,16,38,42.10526315789473,6,3,19,10
2094-142345-0003,234800,118,229,51.52838427947598,50,8,103,68
1188-133604-0028,304080,104,296,35.13513513513514,28,17,175,76
1995-1837-0015,71760,15,70,21.428571428571427,13,2,53,2
6930-81414-0018,46880,13,45,28.888888888888886,3,3,29,10
1284-1181-0010,102960,31,100,31.0,17,1,68,14
4992-23283-0003,74320,23,72,31.944444444444443,8,0,49,15
2300-131720-0041,60000,23,58,39.6551724137931,13,2,33,10
4992-41806-0007,182640,50,178,28.08988764044944,20,5,123,30
7127-75947-0019,62000,26,60,43.333333333333336,4,5,29,22
1320-122617-0015,82000,24,80,30.0,7,2,54,17
7127-75946-0016,179360,55,174,31.60919540229885,17,5,114,38
5105-28241-0004,278640,78,271,28.782287822878228,30,5,188,48
6829-68769-0007,61840,12,60,20.0,5,3,45,7
5683-32866-0001,55520,17,54,31.48148148148148,5,1,36,12
2094-142345-0051,84960,37,82,45.1219512195122,14,2,43,23
1580-141083-0014,45680,24,44,54.54545454545454,10,2,18,14
908-157963-0015,231440,94,225,41.77777777777778,41,5,126,53
4970-29095-0024,96640,25,94,26.595744680851062,14,6,63,11
1284-1181-0020,107680,31,105,29.523809523809526,11,1,73,20
1221-135767-0009,213440,67,208,32.21153846153847,25,5,136,42
3729-6852-0024,88240,26,86,30.23255813953488,11,4,56,15
7127-75947-0029,84560,22,82,26.82926829268293,6,2,58,16
3729-6852-0007,199840,61,194,31.443298969072163,23,9,124,38
1320-122617-0030,63680,26,62,41.935483870967744,6,0,36,20
4507-16021-0046,73440,25,71,35.2112676056338,14,0,46,11
4507-16021-0054,69040,25,67,37.3134328358209,11,2,40,14
121-121726-0013,39840,19,38,50.0,5,1,18,14
2830-3979-0011,151200,69,147,46.93877551020408,26,6,72,43
908-31957-0012,121840,49,118,41.52542372881356,22,6,63,27
8455-210777-0009,73280,35,71,49.29577464788733,11,4,32,24
3575-170457-0001,47840,18,46,39.130434782608695,9,0,28,9
2961-961-0020,98000,31,95,32.631578947368425,15,2,62,16
7176-92135-0042,116320,39,113,34.51327433628318,28,0,74,11
1089-134691-0022,90160,27,87,31.03448275862069,13,2,58,14
4507-16021-0010,242640,84,236,35.59322033898305,41,2,150,43
260-123288-0021,43360,20,42,47.61904761904761,10,2,20,10
4507-16021-0040,62800,27,61,44.26229508196721,11,2,32,16
672-122797-0048,104880,48,102,47.05882352941176,13,9,45,35
1580-141083-0018,42800,19,41,46.34146341463415,7,3,19,12
260-123440-0013,55600,13,54,24.074074074074073,6,0,41,7
1284-1180-0026,132640,35,129,27.131782945736433,21,1,93,14
4507-16021-0019,46880,17,45,37.77777777777778,3,0,28,14
6930-81414-0021,51600,22,50,44.0,9,4,24,13
260-123286-0030,120480,44,117,37.60683760683761,25,4,69,19
7176-92135-0008,70880,25,69,36.231884057971016,17,0,44,8
8455-210777-0063,36160,18,35,51.42857142857142,3,1,16,15
1580-141084-0010,71520,25,69,36.231884057971016,7,5,39,18
8455-210777-0034,123200,62,120,51.66666666666667,33,3,55,29
2094-142345-0056,61440,16,59,27.11864406779661,5,0,43,11
672-122797-0036,85840,28,83,33.734939759036145,8,2,53,20
4970-29093-0003,245680,74,239,30.962343096234306,22,9,156,52
672-122797-0074,139680,79,136,58.08823529411765,8,6,51,71
7176-92135-0030,35760,19,34,55.88235294117647,9,1,14,10
908-31957-0008,160080,58,156,37.17948717948718,20,10,88,38
908-157963-0017,79200,38,77,49.35064935064935,22,3,36,16
4446-2273-0029,52800,24,51,47.05882352941176,12,1,26,12
3729-6852-0035,330400,104,322,32.298136645962735,33,11,207,71
5639-40744-0020,157120,50,153,32.6797385620915,13,4,99,37
61-70970-0008,34400,15,33,45.45454545454545,6,0,18,9
5142-33396-0034,105840,28,103,27.184466019417474,8,3,72,20
121-121726-0014,50640,29,49,59.183673469387756,7,2,18,22
8230-279154-0023,100240,28,97,28.865979381443296,17,3,66,11
237-134500-0040,64480,18,62,29.03225806451613,7,3,41,11
3570-5695-0015,127200,24,124,19.35483870967742,16,8,92,8
7729-102255-0037,176320,45,172,26.16279069767442,22,3,124,23
1320-122617-0002,217360,62,212,29.245283018867923,34,2,148,28
5142-36377-0013,105360,14,102,13.725490196078432,9,3,85,5
3729-6852-0017,287840,84,280,30.0,34,6,190,50
8230-279154-0019,290320,78,283,27.56183745583039,41,4,201,37
8230-279154-0010,243040,82,237,34.59915611814346,48,0,155,34
4446-2275-0029,100480,31,98,31.63265306122449,10,3,64,21
908-157963-0010,100480,34,98,34.69387755102041,9,4,60,25
2094-142345-0001,128480,69,125,55.2,34,3,53,35
4446-2275-0012,96400,31,94,32.97872340425532,10,3,60,21
260-123286-0005,76960,20,75,26.666666666666668,6,3,52,14
5105-28240-0018,46160,15,45,33.33333333333333,5,1,29,10
